%	AGRUPADOR COSTOS ESPECIFICO	General
A	AGRUPADOR COSTOS ESPECIFICO	Preconsulta
B	AGRUPADOR COSTOS ESPECIFICO	Medicina Interna
C	AGRUPADOR COSTOS ESPECIFICO	Oncologia Clinica
D	AGRUPADOR COSTOS ESPECIFICO	Gastroenterologia
E	AGRUPADOR COSTOS ESPECIFICO	Pediatria Oncologica
F	AGRUPADOR COSTOS ESPECIFICO	Neumologia
G	AGRUPADOR COSTOS ESPECIFICO	Psiquiatria
H	AGRUPADOR COSTOS ESPECIFICO	Cuidados Intensivos
I	AGRUPADOR COSTOS ESPECIFICO	Cuidados Paliativos
J	AGRUPADOR COSTOS ESPECIFICO	Emergencia
K	AGRUPADOR COSTOS ESPECIFICO	Anestesiologia
L	AGRUPADOR COSTOS ESPECIFICO	"Cabeza, Cuello y Piel"
M	AGRUPADOR COSTOS ESPECIFICO	Mastologia y Melanomas
N	AGRUPADOR COSTOS ESPECIFICO	Tumores Mixtos
O	AGRUPADOR COSTOS ESPECIFICO	Urologia
P	AGRUPADOR COSTOS ESPECIFICO	Ortopedia
Q	AGRUPADOR COSTOS ESPECIFICO	Neurocirugia
R	AGRUPADOR COSTOS ESPECIFICO	Ginecologia
S	AGRUPADOR COSTOS ESPECIFICO	Medicina Fisica
T	AGRUPADOR COSTOS ESPECIFICO	Imagenologia
U	AGRUPADOR COSTOS ESPECIFICO	Lab Clinico
V	AGRUPADOR COSTOS ESPECIFICO	Lab Citologia
W	AGRUPADOR COSTOS ESPECIFICO	Lab Patologia
X	AGRUPADOR COSTOS ESPECIFICO	Lab Genetica
Y	AGRUPADOR COSTOS ESPECIFICO	Radiooncologia
Z	AGRUPADOR COSTOS ESPECIFICO	Medicina Nuclear
1	AGRUPADOR COSTOS ESPECIFICO	Primer Piso
2	AGRUPADOR COSTOS ESPECIFICO	Segundo Piso
3	AGRUPADOR COSTOS ESPECIFICO	Tercer Piso
4	AGRUPADOR COSTOS ESPECIFICO	Quirofanos
5	AGRUPADOR COSTOS ESPECIFICO	Quimio Ambulatoria
a	AGRUPADOR COSTOS ESPECIFICO	Direccion Ejecutiva
b	AGRUPADOR COSTOS ESPECIFICO	Financiero
c	AGRUPADOR COSTOS ESPECIFICO	Administrativo
d	AGRUPADOR COSTOS ESPECIFICO	Asesoria Juridica
e	AGRUPADOR COSTOS ESPECIFICO	Informatica
f	AGRUPADOR COSTOS ESPECIFICO	Planificacion y D. Org
g	AGRUPADOR COSTOS ESPECIFICO	Registro Nacional de Tumores
h	AGRUPADOR COSTOS ESPECIFICO	Direccion Medica
